400; 200; 20; 0,255,0; 50; 100; 30; 40; 0,0,255
300; 450; 30; 255,0,0; 80; 200; 70; 80; 128,128,0
250; 350; 15; 0,0,255; 30; 150; 20; 30; 255,255,0
500; 400; 25; 255,100,100; 100; 300; 50; 100; 255,0,255
450; 300; 35; 128,0,128; 120; 400; 60; 120; 0,255,0
200; 100; 25; 255,255,0; 90; 250; 40; 80; 255,0,0
350; 150; 40; 0,128,255; 70; 300; 30; 60; 128,128,255

